Sentence	Intent
오늘 시간표 알려줘	시간표조회
오늘 시간표 가르쳐줘	시간표조회
시간표 가르쳐줘	시간표조회
시간표 알려줘	시간표조회
장소 어디야	위치조회
장소 주소 가르쳐줘	위치조회
장소 주소 알려줘	위치조회
장소 어디있어	위치조회
사람 연락처 알려줘	연락처조회
사람 전화번호 알려줘	연락처조회
사람 연락처 가르쳐줘	연락처조회
사람 전화번호 가르쳐줘	연락처조회
날짜 알려줘	날짜조회
날짜 가르쳐줘	날짜조회
지하철 언제와	지하철조회
지하철역 언제와	지하철조회
지하철 언제 도착해	지하철조회
관계자 연락처 알려줘	관계자조회
관계자 연락처 가르쳐줘	관계자조회